################################################################
S             ###                                            ###
############# ### ################## ## ################### ## #
#        # ## #                   ## ## #   ##     #      #  # #
#### ### # ## # ################# ## ## ###  ## ## # #### ## # #
#    # # # ## #  ####           # ## ## ########## # ####### # #
# ## # # # ## #       ######### # ## ##            # #       # #
#### # # # ## # #######       # # ## ############### # ####### #
#      # # ## # ## #    # ##### # ##                 # #       #
# ###### # ## # ## # #### ##### # ########## ######### ####### #
# #    # #    # ## # ######   # # #        # #       # #       #
# # ## # #### # ## #  #     # # # # #### ### # # ### # ### #####
# # ## #      #  # #  ##### # # # ###### ### # # # # # ### #####
# # ## ########### ######## # # # #        # # # # # #  #      #
# # #              #     ## ### # # ##### ## # # # # # ####### #
# # ######### #### #            # # ######## # #   # # #       #
# ### ### ###### # #     ######## # # # # ## ####### # # #######
#                # ########       #                  # #       #
################ #          ##### ### # # ## ### ##### ####### #
#              # ################ ########## # # ##### #       #
# ############ #                  ##         # #     # # #######
# # #    ####  ############################### ####### # #     #
# ###  #   #  ####      #                              # #######
#  ## # #    # ### ###### ################### ##########      ##
## ########### #      ### ##            # ### ############### ##
##         ### ###### ### ## ########## # ### ###             ##
####### ## #            # ## #     #### #     ### ###########  #
# ##### ## ############## ## # ### #### ######### #         # ##
#       ## ##           # ## # # # # ##           ###### ## # ##
########## ## ########### ## # # # # ## ######### #       # # ##
##            #         # ## # # # # ## #   #   # ### ## ## # ##
## ###################### ## # # # # ########## # # # ## #  # ##
## #    ###               ## # # # #   #     ## # # # ## #### ##
## # ##     #### ########### # # # ### # ### ######## ## # ## ##
## # ######## ## #####       # # # # # #              ## # #   #
## #           # #     ##### # # # ### ### ############# # ## ##
## ########### ##### ###   # ### # # # ### #           # #     #
#           ## #   # ### # ##### # ###  ## # ######### # # ### #
#### ###### ## # # #                    ## # ######### # # # # #
# ## #    # ## #   # ##################### #        ## # # # # #
# ## # ## # ## ##### #                     # ###### ## # # # # #
# ## # ## # ## ##    # ####### #################### ## # # # # #
# ##   ## # ## ##### # ##### # ##     #####      ##### # # # # #
# ####### # ## #  ## # #     # ###### ##### ####       # # # # #
#         # ## #  ## # ####### #             ########### # # # #
###  ###### ## ####### #       ############# #           # # # #
### ####### ##         # ################### # ########### ### #
#   #        ########### ###                 # #  ##         # #
# ### ###### ##          ### ############# # # #  ## ######### #
# ### #    # ## ##########      ####### ## # # #  ## #         #
# ### # ## # ############# #### ##      ## ### #  ## # ####### #
#     ######               #### ## #### ##     #  ## #      ## #
# ### #    ####################### #  # ############ #### ######
### #   ##                         #  #              #  #      #
# # ################################################### ###### #
# # #            # #             ##########        #### #### # #
# # # ############ # ########### #          ######           # #
# #                # #         # # ################### ####### #
# ################ # # ####### #            #        #         #
#              ### # #       # ############ # ###### ###########
# ############  #  # # #######              # #                #
#      ####  ## # ## ######  ################ ################ #
# ####      ##                                               # G
################################################################